111111422222222222222222411111111111
111111114222222222222224111111111111
111111111114222222222241111111111111
111111111111444422244411111111111111
111111111111111142241111111111111111
111111111111111142411111111114441111
111111111111011142411111111142224444
111111111110001142244444444444222224
111111111100000114222222222222222224
111111111110001111444444222222222224
111111111111011111111111444442222224
111111111111111111111111111142222224
111111111111111111111111111114222241
111111111111111111111111111114222411
111111111111111111111111111111424111
111111111111111111111111111111444111
111111111111111111111111111111111111
111111111111111111111111111111111111
111111111111111111111111111111111111
111111111111111111111111111111111111
111111111111111111111111111111111111
111111111111111111111111111111111111
111111111111111111111111111111111111
111111111111111111111111111111111111
111111111111111111111111111111111111
111111111111111111111111111111111111
111111111111111111111111111111111111
111111111111111111111111111111111111
-
1,7,9,False
1,12,10,False
1,15,2,False
1,6,6,False
1,2,3,False
1,8,15,False
1,10,16,False
1,1,4,False
1,17,6,False
1,20,16,False
1,24,20,False
1,22,22,False
1,25,8,False
1,27,24,False
2,14,23
2,10,2
2,3,10
2,16,6
2,7,16
2,10,13
2,12,17
2,20,18
3,5,5,0,100
0,12,8
5,13,9,0